 # # # # # # # # # # # # #
# # # # . . . . . # # # #
 # # # . # . . . . # # # #
# # # . . . . . . . # # # #
 # # . . . . . . . . # # # #
# # . . . . . . . . . . . . #
 # . . . . . . . . . . # # . #
# # . . . . . . . . . . # # . #
 # . . . . . . . . . # . # # . #
# . . . . . . . . . . # . # # . #
 # . . . . . . . . . # . # # . #
# # . . . . . . . . . . # # . #
 # . . . . . . . . . . # # . #
# # . . . . . . . . . # # . #
 # # . . # . . . . . . . . #
# # # . # . . . . . # # # #
 # # # . . . . . . # # # #
# # # # # # # # # # # # #

