 # # # # # # # # # # # #
# . . . . # . # . . . . #
 # . . # # . . # # . . #
# . # # . . . . . # # . #
 # . . . # . . # . . . #
# . . . . . . . . . . . #
 # . . . . . . . . . . #
# . . . # . . . # . . . #
 # . . . . . . . . . . #
# . . . . . . . . . . . #
 # . . . # . . # . . . #
# . . . . . . . . . . . #
 # . . . . . . . . . . #
# # . # # . . . # # . # #
 # . . . # . . # . . . #
# . . . # . . . # . . . #
 # . . . # . . # . . . #
# # # # # # # # # # # # #

