 # # # # # # # # # # # # # # # # # # # # # #
# . . . . . . . . . . . . . . . . . . . . . #
 # . . . . # . . . . . . . . . . # . . . . # 
# . . . . . . . . . . . . . . . . . . . . . #
 # . . . . # . . . . . . . . . . # . . . . # 
# . . . . . . . . . . . . . . . . . . . . . #
 # # # # # # # # # # # # # # # # # # # # # #
