 # # # # # # # # # # # # #
# # . . # # # # # # # # #
 # . . . . . . . . # # # #
# . . . # # # # # . # # #
 # . . # # # # # # . # # #
# # # # . . . . . # . # #
 # # # . # # # # . # . # #
# # # . # . . . # . # . #
 # # . # . # # . # . # . #
# # . # # . # # . # . . #
 # . # # . # . # . # # # #
# . # # . # . # # . # # #
 # . # . # . # # # . # # #
# . # . # . # # # . # # #
 # . # . # . # # . # # # #
# # . # . # . # # . # # #
 # . # # . # . # # . # # #
# . # # . # . # # . # # #
 # . # . # . # # . # # # #
# # . . # # . . . # # # #
 # # # # # # # # # # # # #
